1111111111111
1CP10000000C1
1000011111001
1000110E00C01
1111111111111
